Was sind die Prinzipien der freiheitlich-demokratischen Grundordnung?	1. Der materiell-rechtlichen Grundordnung: die Achtung der Menschenrechte, die im Grundgesetz konkretisiert wurden, insbesondere das Recht der Persönlichkeit auf Leben und freie Entfaltung<br>2. Der organisationsrechtlichen Grundordnung: Volkssouveränität, Gewaltenteilung, Verantwortlichkeit der Regierung, Unabhängigkeit der Gerichte<br>3. Den Grundprinzipien der politischen Willensbildung: Mehrparteiensystem, Chancengleichheit politischer Parteien, Recht auf Opposition	DasRepositorium Staatsrecht ÖffR
Bestand der Bundesrepublik	<b>Bestand der Bundesrepublik</b> bedeutet insbesondere deren staatsrechtliche Existenz, völkerrechtliche Unabhängigkeit und territoriale Integrität.	DasRepositorium Staatsrecht ÖffR
Welche Vorraussetzungen machen eine staatliche Maßnahme zum Verwaltungsakt?	- hoheitliche Maßnahme<br />- Behörde<br />- Regelung<br />- Einzelfall<br />- unmittelbare Außenwirkung	DasRepositorium Verwaltungsrecht ÖffR
Was ist mit &quot;hoheitliche Maßnahme&quot; gemeint?	Die Maßnahme muß auf dem Gebiet des Öffentlichen Rechts getroffen werden. Ob das der Fall ist, bestimmt sich wie im Verwaltungsprozeßrecht bei der Frage, ob es sich um eine Streitigkeit auf dem Gebiet des Öffentlichen Rechts handelt, wenn man die Generalklausel des § 40 I 1 VwGO anwendet.	DasRepositorium Verwaltungsrecht ÖffR
Was bedeutet &quot;behördliches Handeln&quot;?<br>Gibt es eine Legaldefinition und wenn ja, wo?	Behörde im Sinne dieses Gesetzes ist jede Stelle, die Aufgaben der öffentlichen Verwaltung wahrnimmt.<br><br>Ja, § 1 IV VwVfG.	DasRepositorium Verwaltungsrecht ÖffR
Was ist ein Einzellfall?	Eine individuell-konkrete oder individuell-abstrakte Maßnahme.	DasRepositorium Verwaltungsrecht ÖffR
Wann ist die Außenwirkung gegeben?	Außenwirkung ist dann gegeben, wenn die Maßnahme darauf gerichtet ist, rechtliche Folgen gegen eine andere Rechtspersönlichkeit zu erzeugen.	DasRepositorium Verwaltungsrecht ÖffR
<span style=" font-style: normal; font-weight: normal;">Schutz der Menschenwürde</span>	<span style=" font-style: normal; font-weight: normal;">Artikel 1</span>	DasRepositorium Grundrechte Staatsrecht ÖffR
<span style=" font-style: normal; font-weight: normal;">Freie Entfaltung der Persönlichkeit, Freiheit der Person, Recht auf Leben, Recht auf körperliche Unversehrtheit</span>	<span style=" font-style: normal; font-weight: normal;">Artikel 2</span>	DasRepositorium Grundrechte Staatsrecht ÖffR
<span style=" font-style: normal; font-weight: normal;">Allgemeines Persönlichkeitsrecht, Recht auf informationelle Selbstbestimmung (Datenschutz), Gewährleistung der Vertraulichkeit und Integrität informationstechnischer Systeme, Recht auf sexuelle Selbstbestimmung</span>	<span style=" font-style: normal; font-weight: normal;">Artikel 1, 2</span>	DasRepositorium Grundrechte Staatsrecht ÖffR
<span style=" font-style: normal; font-weight: normal;">Gleichheitssatz, Gleichberechtigung</span>	<span style=" font-style: normal; font-weight: normal;">Artikel 3</span>	DasRepositorium Grundrechte Staatsrecht ÖffR
<span style=" font-style: normal; font-weight: normal;">Glaubens- und Gewissensfreiheit, Recht auf Kriegsdienstverweigerung</span>	<span style=" font-style: normal; font-weight: normal;">Artikel 4</span>	DasRepositorium Grundrechte Staatsrecht ÖffR
<span style=" font-style: normal; font-weight: normal;">Meinungsfreiheit, Informationsfreiheit, Pressefreiheit, sowie die Freiheit der Kunst und der Wissenschaft</span>	<span style=" font-style: normal; font-weight: normal;">Artikel 5</span>	DasRepositorium Grundrechte Staatsrecht ÖffR
<span style=" font-style: normal; font-weight: normal;">Schutz von Ehe und Familie</span>	<span style=" font-style: normal; font-weight: normal;">Artikel 6</span>	DasRepositorium Grundrechte Staatsrecht ÖffR
<span style=" font-style: normal; font-weight: normal;">Recht auf Schulwahl, auf Erteilung und Teilnahme am Religionsunterricht, zur Errichtung von Privatschulen</span>	<span style=" font-style: normal; font-weight: normal;">Artikel 7</span>	DasRepositorium Grundrechte Staatsrecht ÖffR
<span style=" font-style: normal; font-weight: normal;">Versammlungsfreiheit</span>	<span style=" font-style: normal; font-weight: normal;">Artikel 8</span>	DasRepositorium Grundrechte Staatsrecht ÖffR
<span style=" font-style: normal; font-weight: normal;">Brief- und Postgeheimnis</span>	<span style=" font-style: normal; font-weight: normal;">Artikel 10</span>	DasRepositorium Grundrechte Staatsrecht ÖffR
<span style=" font-style: normal; font-weight: normal;">Freizügigkeit im Bundesgebiet</span>	<span style=" font-style: normal; font-weight: normal;">Artikel 11</span>	DasRepositorium Grundrechte Staatsrecht ÖffR
<span style=" font-style: normal; font-weight: normal;">Freiheit der Berufswahl, Verbot der Zwangsarbeit</span>	<span style=" font-style: normal; font-weight: normal;">Artikel 12</span>	DasRepositorium Grundrechte Staatsrecht ÖffR
<span style=" font-style: normal; font-weight: normal;">Unverletzlichkeit der Wohnung</span>	<span style=" font-style: normal; font-weight: normal;">Artikel 13</span>	DasRepositorium Grundrechte Staatsrecht ÖffR
<span style=" font-style: normal; font-weight: normal;">Eigentumsrechte</span>	<span style=" font-style: normal; font-weight: normal;">Artikel 14</span>	DasRepositorium Grundrechte Staatsrecht ÖffR
<span style=" font-style: normal; font-weight: normal;">Vergesellschaftung, Gemeineigentum</span>	<span style=" font-style: normal; font-weight: normal;">Artikel 15</span>	DasRepositorium Grundrechte Staatsrecht ÖffR
<span style=" font-style: normal; font-weight: normal;">Verbot von Ausbürgerung und Auslieferung</span>	<span style=" font-style: normal; font-weight: normal;">Artikel 16</span>	DasRepositorium Grundrechte Staatsrecht ÖffR
<span style=" font-style: normal; font-weight: normal;">Asylrecht</span>	<span style=" font-style: normal; font-weight: normal;">Artikel 16a</span>	DasRepositorium Grundrechte Staatsrecht ÖffR
<span style=" font-style: normal; font-weight: normal;">Petitionsrecht</span>	<span style=" font-style: normal; font-weight: normal;">Artikel 17</span>	DasRepositorium Grundrechte Staatsrecht ÖffR
<span style=" font-style: normal; font-weight: normal;">Justizgewährleistung, Effektiver Rechtsschutz</span>	<span style=" font-style: normal; font-weight: normal;">Artikel 19 Abs. 4</span>	DasRepositorium Grundrechte Staatsrecht ÖffR
<span style=" font-style: normal; font-weight: normal;">Widerstandsrecht</span>	<span style=" font-style: normal; font-weight: normal;">Artikel 20 Abs. 4</span>	DasRepositorium Grundrechte Staatsrecht ÖffR
<span style=" font-style: normal; font-weight: normal;">Staatsbürgerliche Rechte und Pflichten, gleicher Zugang zu öffentlichen Ämtern</span>	<span style=" font-style: normal; font-weight: normal;">Artikel 33</span>	DasRepositorium Grundrechte Staatsrecht ÖffR
<span style=" font-style: normal; font-weight: normal;">Wahlrecht</span>	<span style=" font-style: normal; font-weight: normal;">Artikel 38</span>	DasRepositorium Grundrechte Staatsrecht ÖffR
<span style=" font-style: normal; font-weight: normal;">Verbot von Ausnahmegerichten</span>	<span style=" font-style: normal; font-weight: normal;">Artikel 101 Abs. 1 Satz 1</span>	DasRepositorium Grundrechte Staatsrecht ÖffR
<span style=" font-style: normal; font-weight: normal;">Recht auf einen gesetzlichen Richter</span>	<span style=" font-style: normal; font-weight: normal;">Artikel 101 Abs. 1 Satz 2</span>	DasRepositorium Grundrechte Staatsrecht ÖffR
<span style=" font-style: normal; font-weight: normal;">Anspruch auf rechtliches Gehöhr</span>	<span style=" font-style: normal; font-weight: normal;">Artikel 103 Abs. 1</span>	DasRepositorium Grundrechte Staatsrecht ÖffR
<span style=" font-style: normal; font-weight: normal;">Verbot der Doppelbestrafung (lat. ne bis in idem)</span>	<span style=" font-style: normal; font-weight: normal;">Artikel 103 Abs. 3</span>	DasRepositorium Grundrechte Staatsrecht ÖffR
<span style=" font-style: normal; font-weight: normal;">(lat. nulla poena sine lege): Gesetzlichkeitsprinzip, Bestimmtheitsgrundsatz, Rückwirkungsverbot</span>	<span style=" font-style: normal; font-weight: normal;">Artikel 103 Abs. 2</span>	DasRepositorium Grundrechte Staatsrecht ÖffR
<span style=" font-style: normal; font-weight: normal;">Selbstbelastungsverbot (lat. nemo tenetur se ipsum accusare) (Derivat aus dem Achtungsgebot der Menschenwürde)</span>	<span style=" font-style: normal; font-weight: normal;">Artikel 103 NN (?)</span>	DasRepositorium Grundrechte Staatsrecht ÖffR
<span style=" font-style: normal; font-weight: normal;">Rechtsgarantien bei Freiheitsentzug (Habeas-Corpus)</span>	<span style=" font-style: normal; font-weight: normal;">Artikel 104</span>	DasRepositorium Grundrechte Staatsrecht ÖffR
<b>Öffentliche Sicherheit</b> im Sinne der Gefahrenabwehraufgabe	<span style="font-style: normal; ">Öffentliche Sicherheit&nbsp;im Sinne der Gefahrenabwehraufgabe ist die Unverletzlichkeit der objektiven Rechtsordnung, der subjektiven Rechte und Rechtsgüter des einzelnen sowie der Einrichtungen und Veranstaltungen des Staates und sonstiger Träger der Hoheitsgewalt.</span>	DasRepositorium Polizeirecht ÖffR
polizeirechtlich "Straftat"	eine <b>rechtswidrige</b> Tat, die den <b>objektiven</b> Tatbestand eines Strafgesetzes verwirklicht	DasRepositorium Polizeirecht ÖffR