Leistung	Als Leistung bezeichnet man im deutschen Recht die bewusste und zweckgerichtete Mehrung fremden Vermögens.	DasRepositorium
Vertragstypische Pflichten im Kaufvertrag	433	DasRepositorium
Sachmangel	434	DasRepositorium
Rechtsmangel	435	DasRepositorium
Herausgabeanspruch (Leistungskondiktion)	812	DasRepositorium
Willenserklärung	Die Willenserklärung ist eine Äußerung, die unmittelbar auf die Herbeiführung eines bestimmten rechtsgeschäftlichen Erfolges gerichtet ist.	DasRepositorium
Geschäftsähnliche Handlung	Wie die Willenserklärung stellt die geschäftsähnliche Handlung eine Äußerung eines Menschen dar. Anders als die Willenserklärung ist die geschäftsähnliche Handlung&nbsp;&nbsp;aber nicht auf eine Rechtsfolge, sondern auf einen tatsächlichen Erfolg gerichtet. Die mit einer geschäftsähnlichen Handlung verbundenen Rechtsfolgen treten nicht ein, weil der Erklärende es so will, sondern weil das Gesetz dies aufgrund der Erklärung eigens anordnet.	DasRepositorium
Realakt	Unter einem Realakt verstehen wir jedes auf einen tatsächlichen Erfolg gerichtete Verhalten eines Menschen, das weder Willenserklärung noch geschäftsähnliche Handlung darstellt.	DasRepositorium
Handlungswille	Mit Handlungswillen bezeichnet man den Willen des Erklärenden, überhaupt mit einem äußerlich wahrnehmbaren Verhalten etwas mitzuteilen, also zu schreiben, zu sprechen, die Hand zu heben, etc.	DasRepositorium
Erklärungsbewusstsein, Rechtsbindungswille	Mit dem Begriff des Erklärungsbewusstseins bzw. Rechtsbindungswillens bezeichnet man das Bewusstsein und den Willen, mit dem Verhalten überhaupt eine rechtsgeschäftliche Erklärung abzugeben und sich dadurch rechtlich binden zu wollen.	DasRepositorium
Geschäftswillen	Als Geschäftswillen bezeichnet man den Willen, mit einem Rechtsgeschäft ganz bestimmte Rechtsfolgen herbeizuführen.	DasRepositorium
Abgabezeitpunkt &quot;nicht empfangsbedürftige Willenserklärung&quot;	Eine nicht empfangsbedürftige Willenserklärung ist abgegeben, wenn sich der Erklärende willentlich geäußert und seinen Äußerungsvorgang nach außen erkennbar abgeschlossen hat.	DasRepositorium
Abgabezeitpunkt &quot;empfangsbedürftige Willenserklärung&quot;	Eine empfangsbedürftige Willenserklärung ist (erst) abgegeben, wenn die Erklärung mit Willen des Erklärenden in Richtung auf den maßgeblichen Empfänger so in den Verkehr gelangt ist, dass mit Zugang gerechnet werden kann.	DasRepositorium
Zugang &quot;unter Abwesenden abgegebene Willenserklärung&quot;	Eine unter Abwesenden abgegebene Willenserklärung geht spätestens in dem Moment zu, in dem sich der Empfänger nach der Verkehrsanschauung üblicherweise und nicht nur durch Zufall Kenntnis vom Inhalt einer in seinen Machtbereich gelangten Erklärung verschaffen kann.	DasRepositorium
Machtbereich des Empfängers	In den Machtbereich des Empfängers (= Adressaten) gelangt die Erklärung, wenn sie in den persönlichen Herrschaftsbereich des Empfänger oder an einen von ihm nach Verkehrsanschauung zur Entgegennahme bereit stehenden Empfangsboten bzw. an eine bereit gehaltene Einrichtung übermittelt wurde.	DasRepositorium
Zugang &quot;nicht verkörperte Willenserklärung gegenüber anwesendem Empfänger&quot;	Eine gegenüber dem anwesenden Empfänger abgegebene, nicht verkörperte Willenserklärung geht diesem zu, wenn der Erklärende bei Anwendung pflichtgemäßer Sorgfalt keine Zweifel an der richtigen vernehmung durch den Empfänger haben kann.	DasRepositorium
Geschäftsfähigkeit	Die Geschäftsfähigkeit ist die Fähigkeit, Rechtsgeschäfte selbstständig vollwirksam vorzunehmen.	DasRepositorium
Paragraphen altersabhängige Geschäftsunfähigkeit	allgemein: §104 Nr. 1 = 0-7 Jahre<br>Sonderfälle: §1303 Abs. 2, §2229 Abs. 1 = 0-16 Jahre	DasRepositorium
Paragraph altersunabhängige Geschäftsunfähigkeit	§ 104 Nr. 2 = nicht nur vorübergehende Störung der Geistestätigkeit	DasRepositorium
Paragraphen beschränkte Geschäftsunfähigkeit	Minderjährige<br>allgemein: §§ 2, 106 = 7-18 Jahre<br>Sonderfälle: §§ 1303 Abs. 2, 2229 Abs.1 = 16-18 Jahre<br>Volljährige, §2<br>gem. §1903 = angeordneter Einwilligungsvorbehalt	DasRepositorium
Ausnahmen Wirksamkeit WE gegenüber beschränkt Geschäftsfähigen	§ 131 Abs. 2	DasRepositorium
Auslegung empfangsbedürftige Willenserklärungen	§§ 133, 157	DasRepositorium
Vorübergehende Störung der Geistestätigkeit	§ 105 Abs. 2	DasRepositorium
Mentalreservation	§ 116	DasRepositorium
Scheingeschäft	§ 117	DasRepositorium
Scherzerklärung	§ 118	DasRepositorium
Widerruf	§ 130 Abs. 1 S.2	DasRepositorium
Vertrag	Ein Vertrag ist die von zwei oder mehreren Personen erzielte Willensübereinstimmung über die Herbeiführung eines rechtlichen Erfolges.	DasRepositorium
Antrag	§ 145	DasRepositorium
Annahme	§ 151	DasRepositorium
offener Einigungsmangel	§ 154	DasRepositorium
versteckter Einigungsmangel	§ 155	DasRepositorium
Rechtsgeschäft	Das Rechtsgeschäft ist das Mittel, mit dem eine Person ihre rechtlichen Verhältnisse nach ihrem Willen gestaltet.	DasRepositorium
Wirksamkeitserfordernisse	Wirksamkeitserfordernisse werden durch solche Normen begründet, die die Wirksamkeit eines konkret zustande gekommenen Rechtsgeschäfts von weiteren Voraussetzungen abhängig machen.	DasRepositorium
Wirksamkeitshindernisse	Wirksamkeitshindernisse werden durch solche Normen begründet, die zur Nichtigkeit eines konkret zustande gekommenen Rechtsgeschäfts führen.	DasRepositorium
Arten der Vertretungsmacht	1. durch Rechtsgeschäft (&quot;Vollmacht&quot;)<br>2. Vertretungsmacht kraft Rechtsscheins<br>3. nach Maßgabe des Gesetzes <br>- Vertretung nicht vollgeschäftsfähiger Menschen<br>- Vertretung von rechtsfähigen Vereinigungen (&quot;Organe&quot;)	DasRepositorium
Organe	Organe sind diejenigen Personen, durch die eine juristische Person oder rechtsfähige Personenvereinigung erst im Außenverhältnis handeln kann.	DasRepositorium
Vollmacht	§§ 167, 168	DasRepositorium
Erteilung einer Vollmacht	- Erklärung gegenüber einem Vertreter, &quot;Innenvollmacht&quot;, § 167 Abs. 1, 1. Var.<br>- Erklärung gegenüber Geschäftspartner, &quot;Außenvollmacht&quot;, § 167 Abs. 1, 2. Var.	DasRepositorium
Erlöschen einer Vollmacht	- durch Erlöschen des Grundverhältnisses, § 168 S. 1<br>- durch Widerruf, 168 S. 2<br>- durch Anfechtung, § 142 Abs. 1<br>- durch Fristablauf, Bedingungseintritt, Verzicht des BEvollmächtigten	DasRepositorium
Kollusion	Nichtigkeit nach § 138 Abs.1 (&quot;Verstoß gegen die guten Sitten&quot;)	DasRepositorium
vorgelegt i.S.d. § 172 Abs. 1	Eine Vollmachtsurkunde wird vorgelegt i.S.d. § 172 Abs. 1, wenn der Vertreter dem Geschäftspartner das Original, eine Durchschrift oder notariell beurkundete Ausfertigung der Urkunde bei Vornahme des Rechtsgeschäfts so zugänglich macht, dass dieser in die Lage versetzt wird, sich unmittelbar Kenntnis von ihrem Inhalt zu verschaffen.	DasRepositorium
Aushändigen	Unter Aushändigen versteht man eine willentliche Übergabe der Urkunde.	DasRepositorium
Duldungsvollmacht	Eine Duldungsvollmacht liegt vor, wenn der Vertretene es wissentlich geschehen lässt, dass ein anderer für ihn wie ein Vertreter auftritt, und der Geschäftsgegner dieses Dulden nach Treu und Glauben dahin verstehen darf, dass der als Vertreter Handelnde bevollmächtigt ist.	DasRepositorium
Anscheinsvollmacht	Eine Anscheinsvollmacht liegt vor, wenn der Vertretene bei pflichtgemäßer Sorgfalt hätte bemerken und verhindern können, dass ein anderer für ihn wie ein Vertreter auftritt, und der Geschäftsgegner das dadurch ermöglichte Vertreterhandeln nach Treu und Glauben dahin versteht und verstehen darf, dass der als Vertreter Handelnde bevollmächtigt ist.	DasRepositorium
Genehmigung	Die Genehmigung ist nach Vornahme des Rechtsgeschäfts erklärte Zustimmung, § 184 Abs. 1.	DasRepositorium
Erwerbsgeschäft	Erwerbsgeschäft i. S. d. § 112 ist jede erlaubte, selbstständige, auf Gewinnerzielung gerichtete Tätigkeit, die nicht unbedingt gewerblich sein muss.	DasRepositorium
Beanstanden	Beanstanden meint wie in § 174 S. 1 unverzügliches Zurückweisen, also ohne schuldhaftes Zögern des Empfängers (§ 121 Abs. 1 S. 1).	DasRepositorium
Eigenschaften	Eigenschaften sind alle für die Wertschätzung einer Sache bzw. Person im konkreten Fall Ausschlag gebenden Faktoren. Der Wert einer Sache als solcher ist demgegenüber keine &quot;Eigenschaft&quot;.	DasRepositorium
Täuschung	Unter Täuschung versteht man die Erregung oder Aufrechterhaltung eines Irrtums über innere oder äußere Tatsachen, das heißt über solche Umstände, die dem Beweise zugänglich sind.	DasRepositorium
Drohung (§ 123 Abs. 1, 2. Var.)	Unter Drohung ist die Ankündigung eines künftigen Übels zu verstehen, auf dessen Eintritt oder Nicht-Eintritt der Drohende einwirken zu können behauptet, und das verwirklciht werden soll, wenn der Bedrohte nicht die vom Drohenden gewünschte Willenserklärung abgibt.	DasRepositorium
grobe Fahrlässigkeit	Unter grober Fahrlässigkeit ist ein Handeln zu verstehen, bei dem die erforderliche Sorgfalt nach den gesamten Umständen in ungewöhnlich großem Maße verletzt worden ist und bei dem dasjenige unbeachtet geblieben ist, was im gegebenen Falle jedem hätte einleuchten müssen.	DasRepositorium
Ausbeuten	Ein Ausbeuten i. S. d. § 138 Abs. 2 liegt vor, wenn eine Partei (= der Wucherer) Kenntnis vom Missverhältnis der Leistungen hat und sich die Zwangslage bzw. Unerfahrenheit etc. der anderen Partei bewusst zu nutze macht. Eine besondere Ausbeutungsabsicht ist nicht erforderlich.	DasRepositorium
billiges Ermessen	Billiges Ermessen ist gewahrt, wenn die festgelegte Leistung unter Berücksichtigung der beiderseitigen Interessen angemssen erscheint.	DasRepositorium
Was ist ein Anspruch?	Ein Anspruch ist das Recht einer Person, von einem anderen ein tun oder Unterlassen zu verlangen (§ 194 Abs. 1). Man spricht auch von &quot;Forderung&quot; (§241 Abs. 1) oder &quot;Schuldverhältnis imd engeren Sinn&quot;, vgl. § 362 Abs. 1.	DasRepositorium
Gläubiger, Schulder	Gläubiger ist der Anspruchsinhaber, Schuldner der Anspruchsgegener, vgl. 241 Abs. 1.	DasRepositorium
Unterschied Anspruch - Obliegenheiten	Obliegenheiten begründen anders als der Anspruch kein Recht auf ein Tun oder Unterlassen, lösen bei ihrer Verletzung auch keinen Schadensersatzanspruch aus § 280 aus, sondern führen &quot;nur&quot; zu einem Rechtsverlust oder sonstigen Rechtsnachteil, der mit der Obliegenheit belasteten Person.	DasRepositorium
Was sind Primäransprüche?	Primäransprüche sind diejenigen Ansprüche, die sich unmittelbar aus dem (wirksamen) Vertrag ergeben.	DasRepositorium
Was sind Sekundäransprüche?	Sekundäranspruche knüpfen an einen wirksamen Vertrag an, entstehen aber erst durch Hinzutreten weiterer Umstände, insbesondere durch Verletzung der Primärleistungspflichten.	DasRepositorium
Rechtsfähigkeit?	Der Begriff Rechtsfähigkeit meint die Fähigkeit, Träger eigener Rechte und Pflichten zu sein.	DasRepositorium
Wofür sind Hilfsnormen da?	Hilfsnormen sollen uns bei der anwendung von Tatbeständen helfen, indem sie Tatbestandsmerkmale definieren und beschreiben.	DasRepositorium
Fälligkeit	Der Begriff Fälligkeit meint allgemein den Zeitpunkt, ab dem der Gläubiger (im Prozess der Kläger) die aufgrund des Anspruchs geschuldete Leistung verlangen kann.	DasRepositorium
Was sind peremptorische Einrede?	dauerhaftes Leistungsverweigerungsrecht	DasRepositorium
Was sind dilatorische Einreden?	vorübergehendes Leistungsverweigerungsrecht	DasRepositorium
Unterschied Einrede - Einwendung	Einreden lassen den Anspruch unberührt fortbestehen. Insbesondere ist er nach wie vor erfüllbar. Er ist aber nicht mehr gerichtlich durchsetzbar, also gehemmt.<br>Einwendungen beseitigen den Anspruch an sich.	DasRepositorium
Unterteilung Rechtsgeschäfte	Einseitige Rechtsgeschäfte sind solche Rechtsgeschäfte, die ihrer Art nach zur Durchführung lediglich eine Willenserklärung erfordern.<br />Mehrseitige Rechtsgeschäfte müssen dagegen aus mindestens zwei Willenserklärungen gebildet werden.	DasRepositorium
Elemente einer Willenserklärung	Handlungswille:<br>&quot;Ich will mich äußern!&quot;<br>Erklärungsbewusstsein/Rechtsbindungswille:<br>&quot;Ich will Rechtsfolgen herbeiführen!&quot;<br>Geschäftswille:<br>&quot;Ich will eine bestimmte Rechtsfolge.&quot;	DasRepositorium
objektiver Tatbestand einer Willenserklärung	Gem. §133 kommt es nie auf den &quot;buchstäblichen Sinne des Ausdrucks&quot; an, deshalb genügt jedes menschliche Verhalten, das - nach Auslegung - einen konkreten Geschäftswillen erkennen lässt.	DasRepositorium
Was ist eine empfangsbedürftige Willenserklärung?	Empfangsbedürftig ist eine Willenserklärung, deren Wirksamkeit den beim Empfänger erfordert.	DasRepositorium
Was ist eine nicht empfangsbedürftige Willenserklärung?	Nicht empfangsbedürftig ist eine Willenserklärung dann, wenn sie, das Fehlen von weiteren Wirksamkeitshindernissen vorrausgesetzt, bereits bei ihrer Abgabe und nicht erst bei Zugang wirksam werden.	DasRepositorium
Wer ist Empfangsbote?	Empfangsbote ist, wer vom Empfänger zur Entgegennahme und Weiterleitung der Erklärung bestellt wurde oder nach der Verkehrsanschauung zumindest aks bestellt anzusehen ist. Entscheidend ist, ob nach der Lebenserfahrung davon ausgegangen werden darf, dass die jeweilige Person ein für den Adressaten entgegengenommenes Schriftstück alsbald an diesen weiterleiten wird.	DasRepositorium
Wie werden Willenserklärungen ausgelegt?	Empfangsbedürftige Willenserklärungen werden nach §§133,157 so ausgelegt wie sie ein objektiver Dritter verstehen durfte (objektivierter Empfängerhorizont), die sogenannte normative Auslegung nach §§133, 157. Ausnahme ist die Falsa demonstratio.<br />Nicht empfangsbedürftige Willenserklärungen werden nur nach § 133 ausgelegt, danach ist der wirkliche Wille ohne die Einschränkung des §157 zu ermitteln. Es dürfen sämtliche Begleitumstände ohne Rücksicht auf ihre Erkennbarkeit für einen konkreten Empfänger berücksichtigt werden. Eine Grenze bildet §116 S.1, also nicht nach außen hervortretende Willensvorbehalte als unbeachtlich erklärt.	DasRepositorium
Was ist die Lehre &quot;vom potentiellen Erklärungsbewusstsein&quot;?	Diese Lehre lässt eine Willenserklärung auch dann wirksamwerden, wenn sie zwar ohne Erklärungsbewusstsein abgegeben wurde, ein objektiver Empfänger sie aber als wirksame Willenserklärung verstehen durfte und das Missverständnis dem Erklärenden zugerechnet werden kann (siehe BGB-AT 1, Rn. 242). Dem Erklärenden bleibt die Anfechtungsmöglichkeit gem. § 119 Abs. 1 mit den entsprechenden Schadensersatzregelungen aus § 122.	DasRepositorium
Welche Auslegungsmethoden gibt es?	<b>Canones nach Savigny:</b><br>- Grammatische Auslegung<br>- Historische Auslegung<br>- Systematische Auslegung<br>- Teleologische Auslegung<br><br><b>weitere:</b><br>- Verfassungskonforme Auslegung<br>- Unionsrechts- oder richtlinienkonforme Auslegung<br>- Rechtsvergleichende Auslegung<br>- Authentische Auslegung	DasRepositorium
Welche Voraussetzungen gibt es für die Anwendung einer Analogie?	- Regelungslücke<br>- Planwidrigkeit<br>- Interessenlage vergleichbar	DasRepositorium
Name (<span style=" font-style: normal; font-weight: normal;">Paragraph)</span>	Der Name ist das äußere (sprachliche) Kennzeichen einer Person zur Unterscheidung ihrer sozialen Individualität gegenüber anderen.<br />§ 12 BGB	DasRepositorium
allgemeines Persönlichkeitsrecht	Unter dem allgemeinen Persönlichkeitsrecht versteht man &quot;das Recht des Einzelnen auf Achtung seiner Menschenwürde und Entfaltung seiner Persönlichkeit, das sich nicht nur gegen den Staat und seine Organe richtet, sondern im Privatrecht gegen Jedermann gilt.&quot; (BGH)	DasRepositorium
Fahrlässigkeit (<span style=" font-style: normal; font-weight: normal;">Paragraph)</span>	Fahrlässig handelt, wer die im Verkehr erforderliche Sorgfalt außer Acht lässt.<br><br>§ 276 (2) BGB	DasRepositorium
Welche Methoden der Gesetzesauslegung kennen Sie?	- Wortlaut<br>- Systematik<br>- Historie<br>- Sinn und Zweck<br>- Verfassungskonform<br>- Gemeinschaftsrechtskonform<br>- Völkerrechtskonform	BGB BGB_AT DasRepositorium
Was bedeutet Rechtsfähigkeit?	- Rechtsfähigkeit bedeutet die Fähigkeit Träger von Rechten und Pflichten zu sein<br>- Rechtsfähig ist jeder Mensch<br>- Beginn vgl. § 1: Geburt – evtl. Vorverlagerung für Ungeborene, vgl. § 1923 II, § 844 II 2	BGB BGB_AT DasRepositorium
Was ist eine juristische Person? Nennen Sie Beispiele!	- Zusammenfassung von Personen (Vermögen bei Stiftung) zu einer Organisation, der die Rechtsordnung Rechtsfähigkeit verliehen hat<br>- im BGB: Verein und Stiftung<br>- weitere: Aktiengesellschaft § 1 I 1 AktG; GmbH § 13 I GmbHG;<br>- Nicht OHG und KG, lediglich rechtsfähige Personengesellschaften (vom BGH faktisch wie jur. Personen behandelt)	BGB BGB_AT DasRepositorium
Ist die Gesellschaft bürgerlichen Rechts (GbR; BGB-Gesellschaft) rechtsfähig?	- Die Außengesellschaft bürgerlichen Rechts ist rechtsfähig – sog. Lehre von der Teilrechtsfähigkeit (a.A. individualistische Theorie: gesellschafter Träger von Rechten und Pflichten).<br>- wegen möglicher Umwandlung in OHG und von verschiedenen Gesetzen anerkannt: Inso, UmwandG<br>- lesen auch Urteil zu Grundbuchfähigkeit der Gbr (NJW 2001, 1056)	BGB BGB_AT DasRepositorium
Was ist ein Vorverein?	Einheitstheorie: Vorverein und eingetragener Verein sind identisch: Die Körperschaft als solche besteht schon vor der Eintragung (Rechtsfähigkeit mit Eintragung § 21 und Verleihung § 22): Das Vermögen/Schulden des Vorvereins geht automatisch mit Erwerb der Rechtsfähigkeit auf den Verein über.	BGB BGB_AT DasRepositorium
Ist der nichtrechtsfähige Verein parteifähig?	- Der Rechtsfähigkeit entspricht im Zivilprozess die Parteifähigkeit, d.h. die Fähigkeit, als Partei vor Gericht aufzutreten: parteifähig ist nach § 50 I ZPO nur, wer rechtsfähig ist.<br />- § 50 II ZPO	BGB BGB_AT DasRepositorium
Was versteht man unter dem Trennungsprinzip?<br>Was unter dem Abstraktionsprinzip?	- Die Trennung von Verpflichtungs- (Begründung schuldrechtlicher Ansprüche) und Verfügungsgeschäft (Einwirken auf Rechtslage durch Aufhebung, Übertragung, Änderung oder Belastung).<br>- Die Wirksamkeit des einen Geschäfts berührt nicht die Wirksamkeit des anderen.	BGB BGB_AT DasRepositorium
In welchen Fällen wird das Abstraktionsprinzip &quot;durchbrochen&quot;?	Fehleridentität, genaugenommen wird es aber nicht durchbrochen, sondern beide Geschäfte sind wegen des gleichen rechtlichen Mangels unwirksam, bspw. § 123.	BGB BGB_AT DasRepositorium
Was ist Zweck des Abstraktionsprinzips?<br>In welchen Fällen wird es besonders bedeutsam?	Schutz des Rechtsverkehrs: die dingliche Rechtslage ist von Störungen auf schuldrechtlicher Ebene isoliert.<br><br>Bei Störungen eines der Rechtsgeschäfte.	BGB BGB_AT DasRepositorium
Was ist ein subjektives Recht? Nehmen Sie eine Einteilung vor!	- Die dem Einzelnen verliehene Rechtsmacht zur Befriedigung bestimmter Interessen.<br>- Absolute subjektive Rechte (ggü. Jedermann: Persönlichkeitsrechte: Körper, Gesundheit, Herrschaftsrecht: Eigentum, Patentrecht, Urheberrecht), relative subjektive Rechte (ggü. einer bestimmten Person: Anspruch, Gestaltungsrecht)	BGB BGB_AT DasRepositorium
Was versteht man unter den Begriffen Handlungsfähigkeit, Geschäftsfähigkeit und Deliktsfähigkeit?	Handlungsfähigkeit ist die Fähigkeit zu rechtlich relevantem Verhalten; Oberbegriff zu Geschäftsfähigkeit (Fähigkeit, RG wirksam vorzunehmen §§ 104 ff) und Deliktsfähigkeit (Fähigkeit, sich durch schuldhaftes handeln verantwortlich zu machen §§ 827,828).	BGB BGB_AT DasRepositorium
Was ist ein Gestaltungsrecht? Nennen Sie Beispiele!	Ein Gestaltungsrecht ist die Befugnis zur einseitigen Rechtsgestaltung.<br>Beispiele sind Anfechtung, Widerruf, Kündigung und Rücktritt.	BGB BGB_AT DasRepositorium
Erläutern Sie den Satz: &quot;Gestaltungsrechte sind bedingungsfeindlich&quot;!	Über die Ausübung eines Gestaltungsrechtes muss Klarheit bestehen, da einseitig die Rechtslage umgestaltet wird. Der Zweck ist Rechtssicherheit, deswegen sind Gestaltungsrechte bedingungsfeindlich, weil der Bedingungseintritt häufig nicht eindeutig ist.	BGB BGB_AT DasRepositorium
Nennen sie die wichtigsten Anspruchsgrundlagen des BGB-AT	- § 122 I (Schadensersatzpflicht des Anfechtenden)<br>- § 179 I, II (Haftung des Vertreters ohne Vertretungsmacht)<br>- § 12 (Namensrecht)<br>	BGB BGB_AT DasRepositorium
Ist § 31 BGB eine Anspruchsgrundlage?	&quot;Haftung des Vereins für Organe&quot;<br>Nein, lediglich eine Verschuldenszurechnungsnorm.	BGB BGB_AT DasRepositorium
Was ist eine Einwendung? Welcher Arten werden unterschieden? Nennen Sie Beispiele!	Gegen einen Anspruch besteht eine Einwendung, wenn er nicht wirksam zustande gekommen ist (rechtshindernde Einwendung, §§ 134, 138, 117, 104, 105, 125) oder wenn er nachträglich erloschen ist (rechtsvernichtende Einwendung §§ 142, 362, 389, 275 I, II, 346); wird von Amts wegen berücksichtigt (?).	BGB BGB_AT DasRepositorium
Was ist eine Einrede? Welche Arten werden unterschieden? Nennen Sie Beispiele!	- Gegen einen Anspruch besteht eine Einrede, wenn ein Leistungsverweigerungsrecht besteht (rechtshemmende Einwendung).<br>- Dauernde: Verjährung § 214<br>- Aufschiebende: §§ 320, 273	BGB BGB_AT DasRepositorium
Was ist eine Sachgesamtheit?	Vgl. § 92 II: Mehrere zusammengefasste Einzelsachen.	BGB BGB_AT DasRepositorium
Was ist ein wesentlicher Bestandteil?	- § 93<br>- Bestandteile einer Sache, die voneinander nicht getrennt werden können, ohne dass der eine oder der andere zerstört oder in seinem Wesen verändert wird.	BGB BGB_AT DasRepositorium
Was ist ein Scheinbestandteil?	- § 95<br />- Sachen die nur zu einem vorübergehenden Zweck eingefügt wurden.	BGB BGB_AT DasRepositorium
Was ist Zubehör?<br>In welchen Vorschriften wird auf Zubehör Bezug genommen?	- Zubehör sind bewegliche Sachen, die, ohne Bestandteile der Hauptsache zu sein, dem wirtschaftlichen Zwecke der Hauptsache zu dienen bestimmt sind und zu ihr in einem dieser Bestimmung entsprechenden räumlichen Verhältnis stehen. (§ 97 I 1)<br>- §§ 311c, 926 I 2, 1120	BGB BGB_AT DasRepositorium
Was sind Nutzungen?	- §§ 99, 100<br>- Früchte oder Vorteile einer Sache<br>- Oberbegriff für Früchte und Gebrauchsvorteile	BGB BGB_AT DasRepositorium
Sind Verbrauch und Verarbeitung Nutzungen? Begründen Sie Ihre Antwort!	Nein, da die Muttersache erhalten bleiben muss.	BGB BGB_AT DasRepositorium
Was versteht man unter dem Begriff Privatautonomie? Was unter Vertragsfreiheit?	- Privatautonomie ist die Freiheit des Einzelnen zur Gestaltung der Rechtsverhältnisse nach seinem Willen (Art. 2 I GG).<br>- Kernbestandteil ist die Vertragsfreiheit: die Abschlussfreiheit (ob und mit wem) und die Inhaltsfreiheit.	BGB BGB_AT DasRepositorium
In welchen Fällen wird die Vertragsfreiheit eingeschränkt?	- Wenn der Schutz des Handelnden es verlangt §§ 104 ff. und Gestaltungsrechte<br />- Schutz des Vertragspartners: §§ 138, AGB-Recht<br />- Zum Schutze Dritter §§ 134, 138, Art. 81 EG (alt)	BGB BGB_AT DasRepositorium
Was ist ein Verfügungsgeschäft?	Ein Rechtsgeschäft, das unmittelbar auf ein bestehendes Rechts einwirkt, sei es durch Übertragung, Aufhebung, Inhaltsänderung oder Belastung.	BGB BGB_AT DasRepositorium
Kann man mit dinglicher Wirkung die Verfügung rechtsgeschäftlich ausschließen?	- Grds. nein, vgl. § 137: Trennung von Verpflichtung und Verfügung<br>- Rechtssicherheit<br>- Ausnahme § 399 Var.2; Gegenausnahme § 354a HGB	BGB BGB_AT DasRepositorium
Worin liegt der Unterschied zwischen einer Bedingung und einer Befristung?	- Bedingung: Nebenbestimmung zu einem Rechtsgeschäft, welche die Wirkungen des Rechtsgeschäftes vom Eintritt eines zukünftigen ungewissen Ereignisses abhängig macht, § 158 (I: aufschiebend, II: auflösend).<br>- Befristung: Wirkungen eines Rechtsgeschäftes werden von Anfangs- oder Endtermin abhängig gemacht, also einem zukünftigen gewissen Ereignis.	BGB BGB_AT DasRepositorium
Wie sind Rechtsgeschäfte von Gefälligkeiten abzugrenzen?	Durch Auslegung, nach dem nach außentretenden Rechtsbindungswillen.	BGB BGB_AT DasRepositorium
Was ist eine Willenserklärung? Aus welchen Elementen besteht sie?	- Willensäußerung einer Person, die unmittelbar auf den Eintritt einer privatrechtlichen Rechtsfolge gerichtet ist.<br>- Objektiver TB: nach außen erkennbare Handlung/Willensäußerung<br>- Subjektiver TB: Handlungswille, Erklärungsbewusstsein, Geschäftswille	BGB BGB_AT DasRepositorium
Was unterscheidet eine Willenserklärung von einer geschäftsähnlichen Handlung?	- Geschäftsähnliche Handlung: Rechtsfolge tritt von Gesetzes wegen ein, kein Rechtsfolgewillen erforderlich.<br>- aber: §§ über WE analog anwendbar (vgl. BGHZ 47, 352, 357; BGH NJW 1987, 1547)	BGB BGB_AT DasRepositorium
Was bedeutet das Rechtssprichwort &quot;falsa demonstratio non nocet&quot;?	Eine falsche Bezeichnung schadet nicht: wenn der Empfänger die WE so verstanden hat, wie der Erklärende sie gemeint hat, gilt die Erklärung mit diesem Inhalt – auf den objektiven Erklärungsgehalt kommt es nicht an, denn insoweit ist niemand schutzwürdig.	BGB BGB_AT DasRepositorium
Ist das Erklärungsbewusstsein notwendiges Element einer Willenserklärung?	Dies ist strittig.<br />- aA: (+) wg. Privatautonomie, aber § 122.<br />- hM: kommt drauf an; wenn Erklärungsfahrlässigkeit und Schutzbedürftigkeit des Dritten, dann nur Anfechtungsrecht analog § 119, aber mit Schadensersatzpflicht analog § 122.	BGB BGB_AT DasRepositorium
Wann ist eine Willenserklärung abgegeben?<br>Wann ist sie zugegangen?<br>Welche Arten von Willenserklärungen muss man dabei jeweils unterscheiden?	Abgabe:<br>- einer nichtempfangsbedürftigen WE: Entäußerung<br>- einer empfangsbedürftigen WE: Wille wird in Richtung auf den Empfänger geäußert/auf den Weg gebracht<br><br>- Anwesend:<br>-- verkörpert: zur Verfügung stellen des Schriftstücks<br>-- mündlich/Fernmündlich: Objektive Wahrnehmungsmöglichkeit<br><br>- Abwesenheit:<br>-- verkörpert: in Verkehr bringen in Richtung auf den Empfänger<br>-- mündlich: Bote<br><br>Zugang § 130I 1 unter Abwesenden<br>- Eine WE ist zugegangen, wenn sie (1) derart in den Machtbereich des Empfängers gelangt ist, dass er (2) unter normalen Umständen (3) Kenntnis erlangen kann.<br>- Es gibt keine gesetzliche Regelung für WE unter Anwesenden: Gedanke des § 130 I 1<br>-- schriftlich, wenn Verfügungsgewalt über Schriftstück<br>-- mündlich: Vernehmungstheorien:<br>_-- Strenge Vernehmungstheorie: wirkliche Vernehmung/Kenntniserlangung<br>_-- Eingeschränkte Vernehmungstheorie: Zugang (+) wenn vernünftigerweise keine Zweifel an richtiger und vollständiger Wahrnehmung besteht.	BGB BGB_AT DasRepositorium
Welche Besonderheiten gelten für den Zugang ggü. nicht voll geschäftsfähigen Personen?	§ 131: Schwebende Unwirksamkeit bis zum Zugang beim gesetzlichen Vertreter.	BGB BGB_AT DasRepositorium
Inwieweit ist der Unterschied zwischen § 104 Nr. 2 BGB und § 105 Abs. 2 BGB bedeutsam?	Dauerhafter oder vorübergehender Zustand der Geschäftsuntüchtigkeit.	BGB BGB_AT DasRepositorium
Kann ein beschränkt Geschäftsfähiger mit seinem Taschengeld wirksam einen Ratenkaufvertrag abschließen?	Nein, der Minderjährige muss die Leistung bewirken: Raten fallen nicht unter den Wortlaut des § 110.	BGB BGB_AT DasRepositorium
Wie ist der Fall einer &quot;abhanden gekommenen&quot;, also ohne Wissen und Wollen des Erklärenden in den Verkehr gebrachten, Willenserklärung zu behandeln?	- WE gelangt in den Verkehr ohne Wissen und Wollen des vermeintlich Erklärenden, BSP: Sekretärin, die ohne Wissen und Wollen vorbereiteten Brief abschickt<br />- P: Wille zum „In den Verkehr bringen“ fehlt, Abwägung zwischen Vertrauensschutz des Rechtsverkehrs und Privatautonomie<br />- Behandlung strittig:<br />- eA: Keine WE – Privatautonomie, allerdings auch Ersatz des Vertrauensschadens, entweder verschuldensunabhängig (§ 122 analog) oder verschuldensabhängig (cic, §§ 280 I, 311 II, 241)<br />- aA: WE (+), Schutz des Rechtsverkehrs überwiegt (BGH), allerdings hat der Äußernde ein Anfechtungsrecht analog § 119 I Alt. 2 und der Empfänger dann einen SE-Anspruch gemäß § 122!<br />Argumente:<br />- Zurechnung von Fehlern im Organisationsbereich<br />- So kann der Erklärende wählen, ob WE gilt oder nicht (Anfechtung)<br />- Schutz und Reibungslosigkeit des Rechtsverkehrs	BGB BGB_AT DasRepositorium
Kommt Schweigen eine rechtserhebliche Bedeutung zu?	Grundsätzlich kommt Schweigen keine rechtsgeschäftliche Bedeutung zu, Teilnehmer am Rechtsverkehr müssen davor geschützt werden, durch Nichtstun rechtlich gebunden zu werden.<br /><br />Ausnahmen<br />Wenn kein Schutzbedürfnis besteht:<br />- beredtes Schweigen: Schweigen ist vereinbart<br />- normiertes Schweigen:<br />Schweigen als Ablehnung: §§ 108 II 2, 177 II 2<br />Schweigen als Annahme: § 516 II: Annahme einer Schenkung; § 362 I HGB<br />- Rechtsprechung: Annahme durch Schweigen bei verspäteter Annahme (=neues Angebot) - strittig<br />- Schweigen auf ein kaufmännisches Bestätigungsschreiben: Wenn der Empfänger eines solchen Schreibens nicht unverzüglich widerspricht, muss er den Inhalt gegen sich gelten lassen.	BGB BGB_AT DasRepositorium
Was versteht man unter dem sog. kaufmännischen Bestätigungsschreiben?	Aus Handelsbrauch entwickelt und gewohnheitsrechtlich anerkannt (Üblichkeit Vertragsinhalt von mündlichen Verhandlungen noch einmal schriftlich festzuhalten, um Streit zu vermeiden, dient der Schnelligkeit und Sicherheit des Rechtsverkehrs)<br />VSS: vgl. Schack Rn. 374 ff.	BGB BGB_AT DasRepositorium
Wann erlischt ein Angebot?	§ 146: Erlöschen bei Ablehnung oder nicht rechtzeitiger Annahme: Rechtzeitig §§ 147 - § 149<br>(unter Anwesenden/Telefon - sofort; Abwesende: Eingang der Antwort unter regelmäßigen Umständen, maßgeblich § 130)<br>§ 148 (Annahmefrist)	BGB BGB_AT DasRepositorium
Worin liegt der Unterschied zwischen den Begriffen &quot;unverzüglich&quot; und &quot;sofort&quot;?	- Unverzüglich: § 121 I, ohne schuldhaftes Zögern („sobald wie möglich“), subjektiver Maßstab, also konkreter Einzelfall<br>- Sofort: unmittelbar danach = objektiver Maßstab (kein Verschuldenselement), also Verhalten/Handlung ohne zu warten	BGB BGB_AT DasRepositorium
Was ist ein freibleibendes Angebot?	Oft wird im Geschäftsverkehr die Wendung „freibleibend“ verwandt: Auslegung (§§ 133, 157) ergibt in solchen Fällen, dass der Erklärende lediglich zur Abgabe eines Angebotes auffordert: „Annahmeerklärung“ ist dann also erst das Angebot, allerdings muss der freibleibend Anbietende dann unverzüglich ablehnen, falls er nicht gebunden werden möchte, Schweigen gilt hier als Annahme: Dies ergibt sich durch Auslegung - Kein Schutzbedürfnis!	BGB BGB_AT DasRepositorium
Was ist Rechtsfolge des § 151 S. 1 BGB?	Liegen die Voraussetzungen des § 151 S. 1 BGB vor, so ist die Erklärung der Annahme &quot;gegenüber&quot; dem Antragenden entbehrlich. § 151 S. 1 BGB verzichtet also nach h.M. nicht (!) auf die Erklärung der Annahme; vielmehr wird die Annahmeerklärung ausnahmsweise nicht als empfangsbedürftige, sondern als nicht-empfangsbedürftige Willenserklärung behandelt.<br>Für die Abgabe dieser Willenserklärung genügt bereits die Entäußerung, sie muss nicht in Richtung auf den Empfänger abgegeben werden. Ausreichend (aber auch notwendig) ist ein als Willensbetätigung zu wertendes, nach außen hervortretendes Verhalten des Empfängers, das vom Standpunkt eines unbeteiligten Dritten auf Grund aller äußeren Indizien auf einen wirklichen Annahmewillen schließen lässt.<br>Eines Zugangs der Annahmeerklärung bedarf es nicht.<br>Typische Fälle solcher Willensbetätigungen sind Erfüllungs-, Aneignungs- oder Gebrauchshandlungen.<br>Bsp. für Anwendungsfall des § 151 BGB:<br>Neuen (technischen) Waren liegt oftmals eine &quot;Garantiekarte&quot; bei. Diese auf Abschluss eines Garantievertrages (vgl. § 443 BGB) gerichtete Erklärung des Herstellers kann vom Kunden stillschweigend angenommen werden, da eine ausdrückliche Antwort offensichtlich nicht erwartet wird.	BGB BGB_AT DasRepositorium
Konstruieren Sie den Vertragsschluss im Supermarkt!	Angebot:<br />- Ausstellen der Ware - strittig:<br />eA: Angebot+, da keine Gefahr der Mehrfachbindung<br />hM: Invitatio ad offerendum: Auslegung: der Geschäftsinhaber kann kein Interesse daran haben, dass das Ausstellen bereits Angebot ist: Gefahr der Falschauszeichnung.<br />Also ist das Angebot entweder Vorlage an der Kasse oder Eintippen des Preises durch den Kassierer<br />- Annahme: Entweder Eintippen des Preises oder Entgegennahme der Ware	BGB BGB_AT DasRepositorium
Konstruieren Sie den Vertragsschluss am Warenautomaten!	Angebot:<br>- eA: Bereithalten des Warenautomaten: essentialia negotii (+), allerdings Angebot unter der Bedingung des ordnungsgemäßen Funktionieren und Bedienens (Argument: Bedingung muss möglich sein, wegen a maiore ad minus-Schluss, da selbst die Bindung an den Antrag ausgeschlossen werden kann)<br>- aA/hM: Antrag des Kunden durch Bedienung des Automaten<br>Annahme: entweder Bedienung des Automaten oder konkludent durch Warenausgabe (Abgabe und Zugang: § 151 S. 1 BGB)	BGB BGB_AT DasRepositorium
Konstruieren Sie den Vertragsschluss in einer Internet-Auktion!	§ 156 ?, hM: keine Versteigerung, da kein Zuschlag!<br>Angebot (strittig):<br>- eA/BGH: Freischaltung der Auktion, Angebot ist befristet und bedingt: befristet bis Auslauf der Auktion und auflösende Bedingung ist ein höheres Gebot<br>- aA: Gebot ist Angebot und Annahme ist vorweggenommen für das höchste Angebot<br>Annahme: entweder Gebot oder vorweggenommene Annahme durch Einstellen	BGB BGB_AT DasRepositorium
Wie ist ein sog. &quot;misslungenes Scheingeschäft&quot; rechtlich einzuordnen?	Eine Partei gibt Erklärung zum Schein ab, andere nimmt Erklärung ernst und wollte das Rechtsgeschäft: Schadenersatz nach § 122	BGB BGB_AT DasRepositorium
Wann liegt lediglich ein rechtlicher Vorteil vor? Kommt es auf eine wirtschaftliche Betrachtungsweise an?	Rechtlicher Vorteil, keine wirtschaftliche Betrachtung, diese Abwägung nimmt gesetzlicher Vertreter vor:<br><br>Verpflichtungsgeschäfte sind immer rechtlich nachteilhaft, da Eingehen einer Verbindlichkeit, Saldierung ist unbeachtlich; lediglich rechtlich vorteilhaft, wenn bloßer Erwerb eines Anspruchs, wie etwa bei Schenkung oder Schuldanerkenntnis.<br><br>Verfügungsgeschäfte: Rechtsverlust ist immer nachteilig, Rechtserwerb grds. vorteilhaft.<br>Problem: Grundstücksschenkungen, denn mit dem Erwerb können Pflichten und Lasten zusammenhängen:<br>Früher hM: Unbeachtlich, da nur mittelbare Folge; dies ist mit dem Schutzzweck des § 107 nicht vereinbar.<br>Heute hM: wertende Gesamtbetrachtung nötig (neue Rspr. des BGH).<br>Annahme einer Leistung als Erfüllung, § 362: Anspruch erlischt: rechtlicher Vorteil strittig:<br>eA: Leistungsannahme lediglich rechtlicher Vorteil<br>hM: dingliches Geschäft wirksam, da rechtlicher Vorteil, allerdings tritt keine Erfüllung ein, da rechtlicher Nachteil, Begründung i.Ü. strittig:<br>- Theorie der Erfüllungsvereinbarung, desw. § 107<br>- Theorie der finalen Leistungsbewirkung (Leistungsbewirkung + Zweckbestimmung); wg. § 107 Zweckbestimmung (-)<br>- Theorie der realen Leistungsbewirkung: Minderjährige hat wg. Schutzzweck des § 107 keine Empfangszuständigkeit<br><br>Ausübung von Rechten: nachteilig, weil Verlust der Rechte und evtl. Abwicklungslast<br><br>Rechtlich neutrale Geschäfte, beispielsweise als Vertreter (§ 165) getane Geschäfte oder Verfügung über fremdes Eigentum: nach hM zustimmungsfrei, teleologische Reduktion des § 107	BGB BGB_AT DasRepositorium
Welche Formarten kennen Sie?	§§ 125 ff<br>- Textform, § 126b<br>- elektronische Form, § 126a<br>- Schriftform, § 126<br>- öffentliche Beglaubigungen, § 129<br>- notarielle Beurkundung, § 128	BGB BGB_AT DasRepositorium
Welche Funktionen können Formvorschriften erfüllen?	- Warnfunktion<br>- Beratungsfunktion<br>- Beweisfunktion	BGB BGB_AT DasRepositorium
Greift die Rechtsfolge des § 125 S. 1 BGB ausnahmslos ein oder gibt es Fälle, in denen &quot;korrigierend&quot; eingegriffen werden muss?	Im Falle des § 242, wenn Berufung auf mangelnde Form rechtsmissbräuchlich ist, aber nie bei Verfügungen wegen Rechtssicherheit<br>- hohe Anforderungen: „schlechthin untragbares Ergebnis&quot;<br>-- Schwere Treuepflichtverletzung (Arglistige Täuschung, nicht vertrauen auf Edelmannwort, obwohl man eigentlich Formvorschrift kennt) und<br>-- Existenzgefährdung<br>- evtl. cic (?)	BGB BGB_AT DasRepositorium
Welche Voraussetzungen und Rechtsfolgen hat die Stellvertretung?	VSS § 164:<br />-- eigene WE des Vertreters<br />-- im Namen des Vertretenen/Offenkundigkeit<br />-- mit Vertretungsmacht (Rechtsgeschäftlich, Gesetz, Rechtsschein)<br />-- passiv: § 164 III<br /><br />Rechtsfolge: Wirkung für und gegen den Vertretenen	BGB BGB_AT DasRepositorium
Welche Prinzipien liegen dem Recht der Stellvertretung zugrunde?	- Repräsentationsprinzip<br>- Offenkundigkeitsprinzip<br>- Abstraktionsprinzip: Vollmacht ist abstrakt vom zugrundeliegenden Rechtsgeschäft	BGB BGB_AT DasRepositorium
Woraus kann sich Vertretungsmacht ergeben?	- Gesetz<br>- Rechtsgeschäft<br>- Rechtsschein	BGB BGB_AT DasRepositorium
Erläutern Sie die Grundsätze über den &quot;Missbrauch der Vertretungsmacht&quot;!	- Umfang der Vertretungsmacht entscheidet über rechtliches Können im Außenverhältnis<br>- Innenverhältnis kann aber Beschränkungen unterliegen: rechtliches Dürfen<br>- P: Auseinanderfallen, z.B. bei Prokura § 49 I HGB<br><br>Überschreitet der Vertreter das rechtliche Dürfen aus dem Innenverhältnis, ist&nbsp;&nbsp;das Außenverhältnis aber rechtlich wirksam; Bindung des Vertretenen.<br><br>Ausnahmen:<br>- Kollusion: § 138<br>- Nicht-kollusiver Missbrauch (strittig):<br>-- Pflichtwidriges Verhalten des Vertreters<br>-- Str. ob auch subj. Pflichtwidrigkeit: hM in der Literatur (-), BGH differenziert nach gesetzlichem Umfang der Vollmacht<br>-- für den Dritten muss Missbrauch evident sein<br>-- Rechtsfolgen: § 242 oder § 177 analog	BGB BGB_AT DasRepositorium
Was ist ein unternehmensbezogenes Geschäft?	Auslegung ergibt, dass die Willenserklärung für Unternehmen gilt, § 164 I 2.	BGB BGB_AT DasRepositorium
Muss ein Vertreter geschäftsfähig sein? Wie steht es im Falle der Botenschaft? Begründen Sie Ihre Antwort!	Vgl. § 165: Vertreter kann beschränkt geschäftsfähiger sein, da die Folgen nicht ihn treffen, vgl. § 164.<br><br>Selbst ein geschäftsunfähiger kann Bote sein, da er keine eigene Willenserklärung abgibt.	BGB BGB_AT DasRepositorium
In welchen Fällen wird das Offenkundigkeitsprinzip durchbrochen?	Geschäft für den, den es angeht, denn dem Vertragspartner ist es gleichgültig - keine Schutzbedürftigkeit<br /><br />Geschäfte des täglichen Lebens - sofortige Bewirkung	BGB BGB_AT DasRepositorium
Erläutern Sie den Begriff der Rechtsscheinsvollmacht!	Der Rechtsverkehr lebt in der Praxis von der Stellvertretung.<br />Der Verkehr muss sich unter bestimmten Voraussetzungen darauf verlassen können, dass eine Vollmacht vorliegt.<br />Unter gewissen Umständen, muss der Rechtsverkehr trotz fehlender Vollmacht geschützt werden<br /><br />Voraussetzungen Rechtsschein:<br />- Zurechenbarkeit<br />- Kausalität des Rechtsscheins für die Disposition eines Dritten<br />- Gutgläubigkeit des Dritten<br /><br />Gesetzliche Regelungen:<br />§§ 170 – 172<br />§ 15 HGB	BGB BGB_AT DasRepositorium
Welche Voraussetzungen und Rechtsfolgen haben die &quot;Duldungsvollmacht&quot; und die &quot;Anscheinsvollmacht&quot;?	Anscheinsvollmacht:<br />Der Vertretene kennt das Handeln des vermeintlichen Vertreters zwar nicht, er hätte es aber bei pflichtgemäßer Sorgfalt erkennen und verhindern müssen und der andere Teil&nbsp;<span style=" font-style: normal; font-weight: normal;">durfte&nbsp;</span>annehmen, der Vertretene dulde und billige das Handeln.<br /><br />Duldungsvollmacht:<br />Vertretene kennt das Verhalten des Vertreters und unternimmt nichts dagegen - konkludent erteilte Vollmacht?!<br />	BGB BGB_AT DasRepositorium
Kann die Erteilung einer Innenvollmacht nach Gebrauch durch den Vertreter angefochten werden?	Vor dem Gebrauch ja, aber auch Widerruf § 168 möglich.<br />Nach Gebrauch: evtl. Schutzbedürftigkeit des Dritten, wegen § 142 I würde rückwirkend Vollmacht wegfallen<br />Anfechtung strittig:<br />- Mm: Anfechtung unbillig, deswegen keine Anfechtung<br />- hM: Anfechtung möglich, Vollmachtserklärung ist Willenserklärung und damit anfechtbar, aber § 122 analog und § 179, Anfechtungsgegner ist der Vertreter (strittig)	BGB BGB_AT DasRepositorium
Welche Bedeutung kommt § 164 Abs. 2 BGB zu?	- Keine Anfechtung wegen Irrtums über Eigengeschäft<br>- Grds. denkbar § 119 I wegen Inhaltsirrtum	BGB BGB_AT DasRepositorium
Ist die Erteilung der Vollmacht formbedürftig? Gibt es Ausnahmen?	§ 167 II: grundsätzlich nein<br>Ausnahmen:<br>Unwiderruflichkeit der Vollmacht, siehe auch BGHZ 89, 47 Rz. 26 m.w.N. (teleologische Reduktion)<br>§ 1945 II BGB; § 2 II GmbHG; § 134 III2, 135 I 1 AktG;	BGB BGB_AT DasRepositorium
Welche Fälle des &quot;In-Sich-Geschäfts&quot; erfasst § 181 BGB?	Selbstkontrahieren und Mehrvertretung	BGB BGB_AT DasRepositorium
In welchen Fällen wird § 181 BGB reduziert? In welchen erweitert?	Einschränkung: lediglich rechtlich vorteilhaft/neutral<br>Ausweitung: Mehrfachvertretungsumgehung durch Untervertreter	BGB BGB_AT DasRepositorium
Was ist ein Bote? Welche Arten kann man unterscheiden und was ist für diese Unterscheidung maßgeblich?	Ein Bote ist eine bloße Hilfsperson, die selber nicht rechtsgeschäftlich tätig wird, sondern lediglich fremde Willenserklärungen übermittelt. Es kommt deswegen auf Geschäftsfähigkeit nicht an.<br><br>Erklärungsbote und Empfangsbote<br><br>Maßgeblich ist die Verteilung der Übermittlungsrisiken/Machtbereiche.	BGB BGB_AT DasRepositorium
Was bedeutet der Satz: &quot;Die Anfechtung ist kein Reuerecht&quot;?	Grundsatz aus Treu und Glauben § 242: der Anfechtende muss sich an dem festhalten lassen, was er ursprünglich gewollt hat.<br>Er soll nicht ganz von dem Abstand nehmen können, was er ursprünglich wollte, sondern nur von dem Teil den er unwillentlich abgeschlossen hat.	BGB BGB_AT DasRepositorium
Was versteht man unter einer "arglistigen Täuschung"?<div>Mit welchen Ansprüchen steht die Anfechtung nach § 123 BGB in einem problematischen Konkurrenzverhältnis?</div>	Täuschung ist erregen, aufrechterhalten oder verstärken eines Irrtums über Tatsachen.<br /><br />Arglist ist Inkaufnahme der Unwahrheit oder Vorsatz.<br /><br />c.i.c. i.V.m. § 249 gerichtet auf Vertragsauflösung: dieser Anspruch könnte hier schon bei leichter Fahrlässigkeit durchgehen - BGH: Ansprüche stehen nebeneinander: unterschiedliche Schutzzwecke, Verjährung	BGB BGB_AT DasRepositorium
Mit welchen Ansprüchen kann eine Anfechtung nach § 119 Abs. 2 BGB in einem problematischen Konkurrenzverhältnis stehen?	§§ 434 ff.: Mit den Ansprüchen aus dem Gewährleistungsrecht.	BGB BGB_AT DasRepositorium
Was ist Parteifähigkeit?	Parteifähigkeit bezeichnet im deutschen Zivilprozessrecht die Fähigkeit, in einem Gerichtsverfahren Kläger oder Beklagter zu sein.<br><br>§ 50 (1) ZPO: Parteifähig ist, wer rechtsfähig ist.	DasRepositorium
Was ist der Nasciturus?	Der Embryo oder Leibesfrucht.	DasRepositorium
Welche tragenden Prinzipien kennt das Sachenrecht?	- Absolutheitsprinzip<div>Dingliche Rechte richten sich gegen jedermann, schützen gegen jedermann und sind von jedermann zu beachten. Im Gegensatz dazu stehen die relativen Rechte, die sich aus Schuldverhältnissen ergeben.</div><div><br /></div><div>-&nbsp;Publizitätsprinzip (Offenkundigkeitsprinzip)</div><div>Der Grundsatz der Publizität oder Offenkundigkeit besagt, dass eine sachenrechtliche (dingliche) Zuordnung jedem der Rechtsordnung erkennbar sein muss.</div><div><br /></div><div>-&nbsp;Spezialitätsgrundsatz (Bestimmtheitsgrundsatz)</div><div>Dingliche Rechte und Rechtsänderungen beziehen sich immer auf eine konkrete Sache. Dies dient der Rechtsklarheit.</div><div><br /></div><div>-&nbsp;Typenzwang (<i>numerus clausus</i>&nbsp;des Sachenrechts)</div><div>Die dinglichen Rechte sind abschließend normiert, d.h., im Gegensatz zum Schuldrecht, wo sich jeder seinen eigenen Vertragstyp ausdenken kann, können hier nur die gesetzlichen Regelungen angewandt werden.</div><div><br /></div><div>eingeschränkte Prinzipien:</div><div><br /></div><div>-&nbsp;Trennungs- und Abstraktionsprinzip</div><div>Das Trennungsprinzip besagt, dass Verpflichtungs- und Verfügungsgeschäft <b>getrennt</b> voneinander sind und das Abstraktionsprinzip, dass Versplichtung und Verfügung <b>abstrakt</b> wirken.</div><div><br /></div><div>-&nbsp;Akzessorietätsprinzip</div><div>Das sichernde Recht hängt am gesicherten Recht (Vormerkung, Hypothek, Pfandrecht akzessorisch zur Forderung).</div>	BGB DasRepositorium Sachenrecht
Besitz	Besitz ist die tatsächliche Sachherrschaft.	BGB DasRepositorium Sachenrecht TODO
Wie kann der Besitzer den unmittelbaren Besitz ausüben? Kann er sich dabei Dritter bedienen?	...? Ja, gemäß §855 BGB kann er sich Besitzdienern bedienen.	BGB DasRepositorium Sachenrecht TODO
Was versteht man unter 'beschränkt' dinglichen Rechten?	Neben dem Eigentumsrecht gibt es eine Reihe von beschränkten dinglichen Rechten. Diese gewähren dem Rechtsinhaber nur einen beschränkten, nach der Art des jeweiligen Rechts ausgestalteten, <b>rechtlichen Zugriff auf die Sache, der</b> insoweit aber wiederum dem umfassenden Recht des Eigentümers, dieses seinerseits beschränkend, <b>vorgeht</b>. Die beschränkten dinglichen Rechte sind also <b>Belastungen</b> des Eigentums durch Nutzungs- und Verwertungsrechte.	BGB DasRepositorium Sachenrecht
Welche beschränkt dinglichen Rechte kennt das BGB?	- die Grunddienstbarkeit nach §§ 1018 ff. BGB<div>-&nbsp;die Reallast nach §§ 1105 ff. BGB</div><div>-&nbsp;die Hypothek nach §§ 1113 ff. BGB</div><div>-&nbsp;die Grundschuld nach §§ 1191 ff. BGB</div>	BGB DasRepositorium Sachenrecht
Was versteht man unter einem Grundstück; wie wird es gebildet?	Als Grundstück bezeichnet man einen räumlich abgegrenzten Teil der Erdoberfläche, der im Grundbuch verzeichnet ist. Es wird aus einer Anzahl Flurstücke gebildet.	BGB DasRepositorium Sachenrecht TODO
Welche Voraussetzungen müssen für eine Grundbucheintragung erfüllt sein?	Voraussetzung für eine Grundbucheintragung sind Eintragungsfähigkeit und Eintragungsantrag. Desweiteren ist gegebenenfalls die Bewilligung desjenigen, dessen Recht von ihr betroffen wird, erforderlich.	BGB DasRepositorium Sachenrecht TODO
Welche Wirkungen hat eine Grundbucheintragung?	Eine Grundbucheintragung hat konstitutive Wirkung...	BGB DasRepositorium Sachenrecht TODO
Wie wird ein Grundstück a) vom Berechtigten b) vom Nichtberechtigten übereignet?	a) durch Einigung und Auflassung<div>b) durch Einigung und Auflassung bei unrichtigem Grundbucheintrag und nur durch ein Verkehrsgeschäft</div>	BGB DasRepositorium Sachenrecht TODO
Der wahre Eigentümer will sich gegen Verfügungen des Buchbesitzers schützen. Wie kann er dies tun?	Er kann einen Widerspruch in das Grundbuch gemäß § 899 per einstweiliger Verfügung eintragen lassen.	BGB DasRepositorium Sachenrecht TODO
P will H dessen Ferrari nicht herausgeben, woraufhin H den P verklagt. Während des Prozesses benutzen - ohne dass der P irgendwas dafür könnte - Jugendliche den Ferrari und beschädigen dabei die Sitze. Welche Ansprüche hat P gegen H, wenn er<div>a) die Sitze reparieren lässt oder</div><div>b) anstelle der Ursprünglichen Standard-Sitze besondere Designersitze einbauen lässt?</div>	a) Anspruch auf Ersatz für notwendige Verwendungen.<div>b) keinen Anspruch auf Ersatz von nützlichen Verwendungen wegen § 996 vorhergehender Rechtshängigkeit.</div>	BGB DasRepositorium Sachenrecht TODO
X möchte seinen Hund B an Y abgeben. Welche Schritte sind erforderlich, damit X dem Y das Eigentum an Bernhard verschafft?		BGB DasRepositorium Sachenrecht TODO
X hat seinen Hund B in einer Kneipe vergessen. Wie kann X, unter Berücksichtigung der besitzrechtlichen Lage, Y das Eigentum an B verschaffen?		BGB DasRepositorium Sachenrecht TODO
Q nimmt versehentlich den Mantel der D, der ihrem ganz ähnlich sieht, an sich.<div>a) Welche Ansprüche hat D gegen Q, wenn Q den Mantel leicht fahrlässig beschädigt?</div><div>b)&nbsp;Welche Ansprüche hat D gegen Q, wenn der Mantel durch ein vollkommen unvorhersehbares Unwetter beschädigt wird?</div><div>c) Wer war unmittelbarer Besitzer des Mantels, bevor Q ihn an sich nahm? (Begründung)</div>	a) § 993, keine Haftung des redlichen Besitzers. Es sei denn er verwechselte schuldhaft, also in diesem Fall fahrlässig, die Mäntel. Dann haftet er aus § 992, 823 I. siehe auch § 276 und § 858<div>b) bei verschuldeter Eigenmacht u. A. aus § 848</div><div>c) D war unmittelbare Besitzerin, da sie den Besitz des Mantels nicht aufgegeben hatte. Aufrechterhaltung des einmal begründeten Besitzes erfordert nicht die selbe örtliche Nähe, wie die Begründung von Besitz.</div>	BGB DasRepositorium Sachenrecht TODO
N verleiht das von E geliehene Buch an D. D veräußert dieses an X, der von der Vorgeschichte nichts weiß, und übergibt es ihm.<div>a) Kann E von X Herausgabe des Buches verlangen?</div><div>b) Kann E von X die Herausgabe des Buches verlangen, wenn D dem N das Buch gegen dessen Willen genommen hat?</div>	a) Nein, da X Eigentümer des Buches geworden ist (§ 932).<div>b) Nein, da § 935 gilt.</div>	BGB DasRepositorium Sachenrecht TODO
Welche Voraussetzungen hat der Anspruch aus §861 BGB?	keine verbotene Eigenmacht dem ursprünglichen Besitzer gegenüber.	BGB DasRepositorium Sachenrecht TODO
Welche Probleme tauchen bei einer petitorischen Widerklage gegen eine possesorische Klage auf? (Erläuterung an den Begriffen des Gesetzes)	Wegen des § 863 kann man sich eigentlich nicht auf das Recht zum Besitz berufen. Das würde zum Ergebnis führen, dass der possessorischen Klage zunächst stattgegeben würde, und sofort zurecht auf § 985 geklagt würde. Daher wird nach h. M. Widerklage zugelassen und sich auf § 864 (2) bezogen.	BGB DasRepositorium Sachenrecht TODO
Was sind die Elemente der Übereignung einer beweglichen Sache? Welche Tatbestände gibt es und welchen Inhalt haben sie?	Einigung und Übergabe. § 929-931	BGB DasRepositorium Sachenrecht TODO
Was sind die Tatbestände und Funktionsweisen der gutgläubigen Erwerbs beweglicher Sachen?	§ 932-934	BGB DasRepositorium Sachenrecht TODO
Was sind die Voraussetzungen des Anspruchs aus §985 BGB? Welchen Rechtscharakter hat §986 BGB?	Eigentum und kein Recht zum Besitz beim anderen. § 986 ist eine rechtshindernde Einwendungen.	BGB DasRepositorium Sachenrecht TODO
B fordert von A vor weiteren Geschäften eine Sicherheit. A besitzt einen von der Y-GmbH geliehenen Traktor, den B als Sicherheit erhalten soll, A aber weiter benutzen und besitzen soll. B war der Auffassung A sei auch Eigentümer. B veräußert den Traktor nun an C, A bleibt aber Besitzer. Hat C das Eigentum an dem Traktor erworben?	- § 985 (-)<div>- § 930 (-)</div><div>- aber § 933 (+)</div><div>-&gt; C wird erst bei Übergabe gutgläubiger Erwerber</div>	BGB DasRepositorium Sachenrecht TODO
enger Verwendungsbegriff	V. sind alle Maßnahmen, die darauf abzielen, den Bestand der Sache <b>als solcher</b> zu erhalten oder wiederherzustellen oder den Zustand der Sache zu verbessern.	BGB DasRepositorium Sachenrecht
weiter Verwendungsbegriff	V. sind alle Vermögensaufwendungen, die einer Sache zugutekommen sollen, insbesondere auch solche, die die Zweckbestimmung ändern.	BGB DasRepositorium Sachenrecht
Erfolgsort	Erfolgsort ist der Ort, an dem der geschuldete Erfolg eintreten soll.	BGB DasRepositorium Schuldrecht_AT
Leistungsort	Leistungsort ist der Ort, an dem der Schuldner die Leistungshandlung vornehmen muss.	BGB DasRepositorium Schuldrecht_AT
Fälligkeit der Leistung	Unter Fälligkeit der Leistung ist allgemein der Zeitpunkt zu verstehen, von dem an der Gläubiger die Leistung verlangen kann.	BGB DasRepositorium Schuldrecht_AT
Erfüllbarkeit der Leistung	Erfüllbarkeit meint den Zeitpunkt, ab dem der Schuldner leisten darf und der Gläubiger bei Nichtannahme in Annahmeverzug gem §§ 293 ff. gerät.	BGB DasRepositorium Schuldrecht_AT
Erfüllungsgehilfe	Erfüllungsgehilfe ist, wer nach den tatsächlichen Verhältnissen mit dem Willen des Schuldners bei der Erfüllung einer diesen treffenden Verbindlichkeiten als seine Hilfsperson tätig wird.	BGB DasRepositorium Schuldrecht_AT
Vorsatz im Sinne des § 276	Vorsatz meint Wissen und Wollen des pflichtwidrigen Erfolges, wobei es genügt, dass der Handelnde den als möglich erkannten pflichtwidrigen Erfolg billigend in Kauf nimmt.	BGB DasRepositorium Schuldrecht_AT
Fahrlässigkeit im Sinne § 276	Gem. § 276 Abs.2 BGB handelt fahrlässig, "wer die im Verkehr erforderliche Sorgfalt außer Acht lässt".	BGB DasRepositorium Schuldrecht_AT
Repräsentanten im Sinne § 31	Zu den unter § 31 fallenden <b>Repräsentanten</b> gehören neben den Organmitgliedern solche Personen, denen kraft Satzung oder durch interne Betriebsregelung wichtige Aufgabenbereiche innerhalb einer rechtsfähigen Vereinigung zur eigenverantwortlichen Erledigung zugewiesen sind und die die Vereinigung insoweit repräsentieren.	BGB BGB_AT DasRepositorium
Mahnung	Mahnung ist die an den Schuldner gerichtete eindeutige Aufforderung des Gläubigers, eine bestimmte Leistung nun bzw. innerhalb der gesetzten Frist zu erbringen.	BGB DasRepositorium Schuldrecht_AT
Teilbarkeit in Teilleistungen	Teilbar ist eine Leistung dann, wenn sie ohne Wertminderung für die einzelnen Teilleistungen als solche und ohne Beinträchtigung des Leistungszwecks in Teilleistungen zerlegt werden kann.	BGB DasRepositorium Schuldrecht_AT
vergebliche Aufwendungen	<b>Vergebliche Aufwendungen</b>&nbsp;sind freiwillige Vermögensopfer, die der Gläubiger im Vertrauen auf den Erhalt der Leistung erbracht &nbsp;hat, die sich aber wegen der Nichtleistung oder der nicht vertragsgerechten Leistung des Schuldners als nutzlos erweisen.	BGB DasRepositorium Schuldrecht_AT
Gegenseitigkeit (Vertrag)	Ein Vertrag ist dann <b>gegenseitig</b>&nbsp;i.S.d §§ 320 ff., wenn die sich aus ihm ergebenden primären Hauptleistungspflichten in der Weise verbunden sind, dass die eine Leistung als Entgelt für die andere Leistung gedacht ist (sog. "synallagmatische verknüpfung").	BGB DasRepositorium Schuldrecht_AT
quantitative Teilbarkeit (Leistung)	Die Leistung ist quantitativ teilbar, wenn sie ohne Wertminderung und ohne Beeinträchtigung des Leistungszwecks der einzelnen Teile geteilt werden kann. Bei vertraglichen Primärleistungspflichten sind Inhalt und Zweck des Vertrages entscheidend.	BGB DasRepositorium Schuldrecht_AT